00000000
11111111
10000001
10211201
10000001
11111111
00000000
00000000
00000000
00000000