11111111
00222200
00011000
01111110
02122120
01111110
02122120
00011000
00222200
11111111