00000000
00001100
00001100
00001100
01111100
01111100
01111100
01111100
00000000
00000000