00000000
00100100
01111110
01122110
00111100
00011000
00000000
00000000
11111111
11111111