11110000
11110000
12110000
11110000
11110000
11110000
11210000
11110000
12110000
11110000