11111111
10200201
01000010
00100100
00011000
02011020
00100100
01000010
10000001
00000000