00000000
02022020
11111111
11211211
11111111
01011010
11111111
00000000
00000000
00000000